14 25
0 0 0 0 0 0 0 0 0 0 0 -1 0 0 0 0 0 0 0 0 -1 0 0 0 0
0 0 -1 0 -1 -1 -1 -1 -1 -1 0 -1 0 -1 -1 -1 -1 -1 -1 0 -1 0 -1 -1 0
-1 0 -1 0 0 0 0 0 0 -1 0 -1 -2 -3 -4 0 -6 0 0 0 0 0 0 0 -5
-1 0 -1 -1 -1 -1 0 -1 0 0 0 0 0 -1 0 0 -1 -1 -1 -1 -1 -1 -1 -1 0
-1 0 0 0 0 0 0 -1 -1 -1 -1 -1 0 -1 0 -1 -1 -1 -1 -1 0 0 0 0 0
-1 0 -1 -1 -1 -1 0 0 0 0 0 0 0 0 0 0 -1 -1 0 0 0 -1 -1 -1 -1
-1 0 0 0 0 0 0 -1 -1 -1 -1 0 -1 -1 0 -1 -1 -1 0 -1 -1 -1 -1 -1 -1
-1 0 -1 -1 -1 -1 0 0 0 0 0 0 0 0 0 0 0 0 0 -1 -1 -1 -1 -1 -1
-1 0 0 0 0 0 -1 -1 -1 0 -1 -1 -1 -1 -1 -1 -1 -1 0 -1 -1 -1 -1 -1 -1
-1 0 -1 -1 -1 -1 0 1 -1 0 0 0 0 0 0 0 0 0 0 0 -1 -1 -1 -1 -1
-1 0 0 0 0 0 0 0 0 0 -1 -1 -1 -1 -1 -1 -1 -1 -1 -1 -1 -1 -1 -1 -1
-1 0 -1 -1 -1 -1 -1 -1 -1 -1 -1 -1 -1 -1 -1 -1 -1 -1 -1 -1 -1 -1 -1 -1 -1
-1 0 -1 -1 -1 -1 -1 -1 -1 -1 -1 -1 -1 -1 -1 -1 -1 -1 -1 -1 -1 -1 -1 -1 -1
-1 -1 -1 -1 -1 -1 -1 -1 -1 -1 -1 -1 -1 -1 -1 -1 -1 -1 -1 -1 -1 -1 -1 -1 -1


