14 25
0 0 -1 0 0 0 0 0 0 -1 0 0 0 0 0 0 -1 0 0 0 0 -1 0 0 -1
0 0 -1 -1 0 -1 -1 -1 -2 0 0 0 0 0 0 0 -1 0 0 0 0 -1 0 0 -1
0 0 0 0 0 0 -1 0 0 -1 0 0 0 0 0 0 0 0 0 0 0 -1 0 0 -1
0 0 0 -1 -1 0 0 0 0 -1 0 0 -1 -1 -1 0 0 0 -1 -1 0 -1 0 0 -5
-1 0 0 0 -1 0 0 0 0 -1 0 0 0 -6 0 0 -1 0 0 0 0 -1 0 0 -1
-1 0 -1 0 0 0 0 0 0 0 0 0 0 0 0 0 -1 0 0 0 0 -1 0 0 -1
-1 0 -1 0 0 0 0 0 0 -1 0 -1 -1 -1 0 0 -1 0 0 0 0 -1 0 0 -1
-1 0 0 0 -1 0 0 0 0 0 0 0 0 0 0 0 -1 0 0 0 0 -1 0 0 -1
-1 0 -1 0 0 0 0 0 0 -1 0 0 -1 -1 -1 0 0 0 0 0 0 -1 0 0 0
-1 0 0 0 0 0 0 0 0 -1 -1 0 0 0 0 0 -1 0 0 -4 0 0 0 0 -1
-1 0 -1 0 0 0 0 0 0 -1 0 -1 0 0 0 0 -1 0 0 0 0 -1 0 0 -1
-1 0 -1 0 0 0 0 -1 -1 -1 0 0 -1 0 -3 0 -1 0 0 0 0 0 0 0 -1
-1 0 -1 0 0 0 0 0 0 0 0 -1 0 0 0 0 -1 0 0 0 0 -1 0 0 -1
-1 0 -1 0 0 0 0 -1 -1 -1 0 0 0 0 0 0 -1 0 0 0 0 -1 0 0 -1  


